
     NO         ./path_to_the_north_texture.xpm
SO      ./path_to_the_south_texture.xpm
    WE     ./path_to_the_west_texture.xpm
EA    ./path_to_the_east_texture.xpm
                    C  225,30,0
F   220,100,0


    111111111111111
 111001111
1110E0111111
11111111
    11111111111
    1000000101
111111111111111111