EA    ./path_to_the_east_texture.xpm 
C  0,211,12
NO    ./path_to_the_north_texture.xpm
SO   ./path_to_the_south_texture.xpm
WE   ./path_to_the_west_texture.xpm

F 12,121,154
     1111111111111111111111111111
     111111111111111111111111111111
 1  1 10000001100000000000010001
1011011101110000000000001111111111
10010000000000000000000011111111
11111111101000001110000000000001
1000000000110000011101111111111111
1111011111111011100000010001
11110111111111011101010010001
11110111W11111011101010010001
11110111111111011101010010001
11000000110101011100000010001
10000000000000001100000010001
1000000000000001101010010001
110000011101010111110111100111
11110111 1110101 101111010001
11111111 1111111 111111111111
    11        
    11
    11
111111111