
    C  225,30,0
    NO     ./path_to_the_north_texture
   SO      ./path_to_the_south_texture
  WE     ./path_to_the_west_texture
  EA    ./path_to_the_east_texture
   F  220,100,0


1111111111111111
1000N0000001  11111
1111111111111111
111111111111111111
10000000000111
11100000000001
1000000000011
1000010000001111111111111
100000000001
111111111111

