
    C  225,30,0
    NO     ./path_to_the_north_texture
   SO      ./path_to_the_south_texture
  WE     ./path_to_the_west_texture
  EA    ./path_to_the_east_texture
   F  220,100,0
11111111111111111111111111111111111111111
1000N0000000000100101000000000000000000001
10000000000100001001000111000000000000001
10000000000100000010000000000000010000001
10000010000111111100001000011000000000001
10000100000000000100000000001000010000001
10000000001111100100010000001000000000001
10001000000000000000000001000000001000001
10010000000100000011000000000000001010001
10011010000111110001001000000000000010001
101000100001010100000010000000111110100001
10110010000001010000001111110000001110001
10010010000100010000001000000001111000001
10000010000111110000001111110000000000001
11111111111111111111111111111111111111111
