
    C  0,139,139
NO ./textures/GrasswallL.xpm
SO ./textures/SnowbrickL.xpm
WE ./textures/MultibrickL.xpm
EA ./textures/StoneUWL.xpm
   F  218,165,32

         11111111111111111111111111
         1000000000110000000000N11
         11111100000000111111111111
1111111110000000000000011111111111
1011000001110000000000001111111111
11110010000000000000000001111111111
11111111101100000111000000000000111
1111011111111101110000001000111111
11110111 11111101110101001000111111
11000000110101011100000010001111111
10000000000000001100000010001111111
10000000000000001101010010001111111
1100000111010101111101111000111111
11110111 1110101 10111101000111111
11111111 1111111 11111111111111
1111111111111111111111111111111
