
NO textures/simonkraft/bookshelf.xpm
SO textures/simonkraft/bookshelf_01.xpm
WE textures/simonkraft/bookshelf_02.xpm
EA textures/simonkraft/bookshelf_03.xpm 
F 220,100,11
C 225,30,1


         1111111111111111111111111
         1000000000110000000000111
         1111111111111111111111111
11111111111111111111111111111
1011000001110000000000001 
100100000000000000001111111111111
11111111101100000111110000000000E1
111101111111110111000100100011111
11110111 111111011101010010001
11000000110101011100000010001
10000000000000001100000010001
10000000000000001101010010001
1100000111010101111101111000111
11110111 1110101 101111010001
11111111 1111111 11111111111
111111111111111 