
    C  225,30,0
    NO     ./path_to_the_north_texture
   SO      ./path_to_the_south_texture
  WE     ./path_to_the_west_texture
  EA    ./path_to_the_east_texture
   F  220,100,0
 1111111111111111111111111111111111111111
10000010000000001001010000000000000000001
10000010000010000100100011100000000000011
10000000000100000010000000000000010000011
100000100001111111000010000110000000000D1
100000D0000000000100000000001000010000011
10000010001111100100010000001000000000011
100000D0000000000000000001000000001000001
100100100001000000110000000000000010100N1
10011010000111110001001000000000000010001
10100010000101010000001000000011111010001
10110010000001010000001111110000001110001
10010010000100010000001000000001111000001
10000010000111110000001111110000000000001
 111111111111111111111111111111111111111 
